{
  "version": 1,
  "name": "personal_defense_obstacle_layout_10x8",
  "description": "个人端综合演示障碍物布局：使用三组竖向货架列形成绕行通道，同时避开默认 AGV 和常用业务点位。",
  "grid_cols": 10,
  "grid_rows": 8,
  "blocked_cells": [
    { "x": 2, "y": 0 },
    { "x": 2, "y": 1 },
    { "x": 2, "y": 2 },
    { "x": 2, "y": 4 },
    { "x": 2, "y": 5 },
    { "x": 2, "y": 6 },
    { "x": 4, "y": 0 },
    { "x": 4, "y": 1 },
    { "x": 4, "y": 3 },
    { "x": 4, "y": 4 },
    { "x": 4, "y": 6 },
    { "x": 4, "y": 7 },
    { "x": 7, "y": 0 },
    { "x": 7, "y": 2 },
    { "x": 7, "y": 3 },
    { "x": 7, "y": 4 },
    { "x": 7, "y": 6 },
    { "x": 7, "y": 7 }
  ]
}
